for|for
ronga|
12|
studinte|stud-int-e
drogo|drog-o
rapide|rapid-e
situacio|situaci-o
horo|hor-o
kutima|kutim-a
kaŝanta|kaŝ-ant-a
nedeviga|ne-dev-ig-a
soifi|soif-i
san-franciska|
sep|sep
svislando|svis-land-o
detalo|detal-o
zorgi|zorg-i
scivolema|sci-vol-em-a
liberigi|liber-ig-i
kunulo|kun-ul-o
antaŭi|antaŭ-i
ĵi|
bone|bon-e
ridante|rid-ant-e
misio|misi-o
instruanto|instru-ant-o
faktoro|faktor-o
honesteco|honest-ec-o
malgrasulo|mal-gras-ul-o
mispaŝi|mis-paŝ-i
senpene|sen-pen-e
forlasi|for-las-i
samlernejano|sam-lern-ej-an-o
marŝinta|marŝ-int-a
libreto|li-bret-o
scivolemo|sci-vol-em-o
nacilingve|naci-lingv-e
senkuraĝiga|sen-kuraĝ-ig-a
ĉar|ĉar
ŝofori|ŝofor-i
komforta|komfort-a
ver-ŝajne|ver-ŝajn-e
malgranda|mal-grand-a
fuŝema|fuŝ-em-a
telero|teler-o
kato|kat-o
si|si
pordo|pord-o
parolado|paro-lad-o
asimili|asimil-i
soldato|soldat-o
oportune|oportun-e
cetere|ceter-e
rekomenci|re-komenc-i
esploro|esplor-o
ofta|oft-a
ekhavi|ek-hav-i
malmulta|mal-mult-a
firma|firm-a
sendube|sen-dub-e
diskrete|diskret-e
infan-voĉo|infan-voĉ-o
timinda|tim-ind-a
faktultato|
ekpaŝi|ek-paŝ-i
samo|sam-o
brako|brak-o
ilo|il-o
da|
stile|stil-e
spioni|spion-i
pasado|pas-ad-o
kanto-kasedo|kanto-kased-o
ĉia-okaze|ĉia-okaz-e
lingva|lingv-a
urbo|urb-o
malmulte|mal-mult-e
verda|verd-a
spionraporto|spion-raport-o
poŝtoficejo|poŝt-ofic-ej-o
ŝoforo|ŝofor-o
dum|dum
portante|port-ant-e
malhelpi|mal-help-i
verkita|verk-it-a
timegi|tim-eg-i
atendi|atend-i
defendi|defend-i
vivi|viv-i
mistero|mister-o
obstineco|obstin-ec-o
ekzemplo|ekzempl-o
interpretista|interpret-ist-a
sidiĝi|sid-iĝ-i
eksidi|ek-sid-i
gardostari|gardo-star-i
peze|pez-e
ekzemple|ekzempl-e
dek|dek
okazi|okaz-i
teni|ten-i
blindulo|blind-ul-o
12|
promeni|promen-i
dankinde|dank-ind-e
maldiskreta|mal-diskret-a
mire|mir-e
rediri|re-dir-i
johá|
kuŝi|kuŝ-i
konduki|konduk-i
interese|interes-e
granda|grand-a
vojaĉo|voj-aĉ-o
samtempe|sam-temp-e
stranga|strang-a
opinio|opini-o
dormi|dorm-i
stari|star-i
lia|li-a
stulte|stult-e
semajno|semajn-o
helpi|help-i
instruisto|instru-ist-o
legante|leg-ant-e
malafabla|mal-afabl-a
malforta|mal-fort-a
tradicio|tradici-o
fenestro|fenestr-o
eltiri|el-tir-i
agado|ag-ad-o
gratuli|gratul-i
riparisto|rip-arist-o
virino|vir-in-o
resti|rest-i
danki|dank-i
kursgvidanto|kurs-gvid-ant-o
fako|fak-o
koni|kon-i
ĉi|ĉi
elporti|el-port-i
esprimi|esprim-i
soleca|sol-ec-a
ĉefe|ĉef-e
piedo|pied-o
dormante|dorm-ant-e
«kriptografio»|
hotelo|hotel-o
ĝojo|ĝoj-o
rilati|rilat-i
35|
ĝenevo|
bonvoli|bon-vol-i
tro|
bedaŭrinde|bedaŭr-ind-e
lingvo-lernado|lingvo-lern-ad-o
amanto|am-ant-o
preskaŭ|preskaŭ
fenestro-kovrilo|fenestro-kovr-il-o
proksimeco|proksim-ec-o
koncerni|koncern-i
ĝisfunde|ĝis-fund-e
mallumo|mal-lum-o
ilustraĵo|ilustr-aĵ-o
dorme|dorm-e
la|la
roko|rok-o
petro|
flughaveno|flug-haven-o
kii|
celi|cel-i
16|
necesa|neces-a
nekonata|ne-kon-at-a
emi|em-i
ŝteli|ŝtel-i
kun-labori|kun-labor-i
perdi|perd-i
studento|student-o
kredi|kred-i
ĝemi|ĝem-i
malakcepti|mal-akcept-i
propra|propr-a
ŝati|ŝat-i
fali|fal-i
sentimulino|sen-tim-ul-in-o
mirinde|mir-ind-e
nek|nek
ŝtela|ŝtel-a
20|
montaro|mont-ar-o
gestudento|ge-student-o
ŝategi|ŝat-eg-i
reveni|re-ven-i
rifuzo|rifuz-o
antaŭe|antaŭ-e
muskolo|muskol-o
mallarĝa|mal-larĝ-a
konsisti|konsist-i
trezoro|trezor-o
okazo|okaz-o
pravigi|prav-ig-i
des|des
leganto|leg-ant-o
administra|administr-a
novjorko|
laborinta|labor-int-a
miskompreni|mis-kompren-i
plezuro|plezur-o
publikigi|publik-ig-i
monato|monat-o
rajto|rajt-o
polico|polic-o
junulino|jun-ul-in-o
seruro|serur-o
manĝaĵo|manĝ-aĵ-o
jam|jam
angla|angl-a
interkompreno|inter-kompren-o
ke|ke
harmoniigo|harmoni-ig-o
instrui|instru-i
flanka|flank-a
entute|en-tut-e
kaŝe|kaŝ-e
ina|in-a
eliri|el-ir-i
taso|tas-o
scii|sci-i
kavo|kav-o
fine|fin-e
ŝia|ŝi-a
je|je
dekkvina|dek-kvin-a
reiri|re-ir-i
servistino|ser-vist-in-o
ĉambro|ĉambr-o
peco|pec-o
dormigi|dorm-ig-i
uzata|uz-at-a
sankta|sankt-a
zorgo|zorg-o
mistera|mister-a
sensoifiga|sen-soif-ig-a
peto|pet-o
ses|ses
artikolo|artikol-o
kondiĉo|kondiĉ-o
enveni|en-ven-i
lasta|last-a
bonega|bo-neg-a
societo|societ-o
lernejo|lern-ej-o
forgesi|forges-i
rifuzi|rifuz-i
kofro|kofr-o
jes|jes
ricevi|ricev-i
ĉapitro|ĉapitr-o
loka|lok-a
sia|si-a
ŝtata|ŝtat-a
malnova|mal-nov-a
enlasi|en-las-i
mondo|mond-o
nomo|nom-o
tiam|tiam
nigra|nigr-a
kvardek|kvar-dek
aĉeti|aĉet-i
servo|serv-o
frue|fru-e
sukerpeco|suker-pec-o
sincere|sincer-e
pensema|pens-em-a
nokte|nokt-e
unuigo|unu-ig-o
ĉe|ĉe
paroli|parol-i
fortulo|fort-ul-o
ejo|ej-o
traduki|traduk-i
universitata|universitat-a
senespera|sen-esper-a
kuŝe|kuŝ-e
rimedo|rimed-o
kuŝigi|kuŝ-ig-i
iĝi|iĝ-i
restoracio|restoraci-o
longeco|long-ec-o
ŝanĝi|ŝanĝ-i
nenii|neni-i
korpa|korp-a
divido|divid-o
ino|in-o
honesta|honest-a
pli|pli
kampo|kamp-o
ŝi|ŝi
intertempe|inter-temp-e
buso|bus-o
iradi|ir-ad-i
legi|leg-i
mia|mi-a
amikiĝema|amik-iĝ-em-a
centro|centr-o
daŭre|daŭr-e
sufiĉe|sufiĉ-e
feliĉe|feliĉ-e
ĝoji|ĝoj-i
dirante|dir-ant-e
aventura|aventur-a
vojeto|voj-et-o
senvorte|sen-vort-e
ekde|
jene|jen-e
ĉeesti|ĉe-est-i
voĉeto|voĉ-et-o
ekscii|ek-sci-i
6|
pensi|pens-i
belulino|bel-ul-in-o
havi|hav-i
daŭrigi|daŭr-ig-i
sukero|suker-o
eva|
preni|pren-i
kvi|
ellitiĝi|el-lit-iĝ-i
obei|obe-i
novelo|novel-o
neamatoro|ne-amator-o
silento|silent-o
protestanto|protestant-o
kultura|kultur-a
kolbaso|kolbas-o
frataro|frat-ar-o
lumserĉanto|lum-serĉ-ant-o
psikologio|psikologi-o
demando|demand-o
intereso|interes-o
organizi|organiz-i
fuŝe|fuŝ-e
panei|pane-i
komenti|koment-i
gravi|grav-i
proksima|proksim-a
obstina|obstin-a
libera|liber-a
refermi|re-ferm-i
muro|mur-o
deziri|dezir-i
sinjoro|sinjor-o
pala|pal-a
kompreneble|kompren-ebl-e
lingvistika|lingvistik-a
lasi|las-i
certiĝi|cert-iĝ-i
mallibereco|mal-liber-ec-o
ŝlosilo|ŝlos-il-o
aŭdebli|aŭd-ebl-i
igi|ig-i
sekvanta|sekv-ant-a
spegulo|spegul-o
surbendigita|sur-bend-ig-it-a
vespero|vesper-o
trans|trans
dolora|dolor-a
sidi|sid-i
nekonato|ne-kon-at-o
deziro|dezir-o
enmiksi|en-miks-i
kontroli|kontrol-i
malhonesta|mal-honest-a
plumo|plum-o
telefone|telefon-e
sata|sat-a
generacio|generaci-o
profesio|profesi-o
malestime|mal-estim-e
rimarko|rimark-o
dumtempe|dum-temp-e
trovita|trov-it-a
gardanto|gard-ant-o
tiea|tie-a
forveturi|for-vetur-i
malantaŭ|mal-antaŭ
9|
gardi|gard-i
realigi|real-ig-i
longa|long-a
akvo|akv-o
sportocentro|sporto-centr-o
faligi|fal-ig-i
komenci|komenc-i
rigardadi|rigard-ad-i
plurfoje|plur-foj-e
malkontentigi|mal-kontent-ig-i
civitano|civit-an-o
okaze|okaz-e
sukceso|sukces-o
asimilinte|asimil-int-e
spirito|spirit-o
antaŭparolo|antaŭ-parol-o
nee|ne-e
edzino|edz-in-o
malserioza|mal-serioz-a
danco|danc-o
timiga|tim-ig-a
ekstere|ekster-e
nature|natur-e
komuniki|komunik-i
alivorte|ali-vort-e
loko|lok-o
enkondukata|en-konduk-at-a
uzate|uz-at-e
speco|spec-o
vojo|voj-o
kompatemo|kompat-em-o
lumo|lum-o
muzeo|muze-o
plaĉa|plaĉ-a
iomete|io-met-e
jardeko|jar-dek-o
irigi|ir-ig-i
ŝtelisto|ŝtel-ist-o
jese|jes-e
humuro|humur-o
demandado|demand-ad-o
ji|
amatoreco|amator-ec-o
legado|leg-ad-o
videbla|vid-ebl-a
sendi|send-i
kiom|kiom
aŭdeble|aŭd-ebl-e
vekiĝanta|vek-iĝ-ant-a
insulo|insul-o
claude|
ŝtono|ŝton-o
22|
=|
gerda|
motivi|motiv-i
aldoni|al-don-i
morgaŭa|morgaŭ-a
urĝe|urĝ-e
maniero|manier-o
biblioteko|bibliotek-o
moviĝi|mov-iĝ-i
kvar|kvar
sekrete|sekret-e
malaperinta|mal-aper-int-a
stariĝante|star-iĝ-ant-e
teo|te-o
apenaŭ|apenaŭ
ekridi|ek-rid-i
diversa|divers-a
sinsekvo|sin-sekv-o
devo|dev-o
afable|afabl-e
lumoserĉanto|lumo-serĉ-ant-o
mil|mil
trezorserĉanto|trezor-serĉ-ant-o
82|
not-libro|not-libr-o
manĝo-bruo|manĝo-bru-o
suspekti|suspekt-i
malĝojo|mal-ĝoj-o
malkovri|mal-kovr-i
aĉa|aĉ-a
piro|pir-o
edzo|edz-o
kaŝita|kaŝ-it-a
laŭt-legi|laŭt-leg-i
liberi|liber-i
kosti|kost-i
lakto|lakt-o
hezitante|hezit-ant-e
mekaniko|mekanik-o
inter-kompreniĝo|inter-kompren-iĝ-o
35|
duonhoro|du-on-hor-o
graveco|grav-ec-o
di|
koridora|koridor-a
noti|not-i
tempo-spaco|tempo-spac-o
memserva|mem-serv-a
reala|real-a
ege|eg-e
konsideri|konsider-i
hejmo|hejm-o
troviĝi|trov-iĝ-i
li|li
direkto|direkt-o
tie|tie
efika|efik-a
hejme|hejm-e
amiko|amik-o
tero|ter-o
morgaŭ|morgaŭ
doni|don-i
prezentiĝi|prezent-iĝ-i
malkonsenti|mal-konsent-i
sekureco|sekur-ec-o
dua|du-a
afriko|
kapti|kapt-i
afero|afer-o
ekbati|ek-bat-i
solene|solen-e
esprimo|esprim-o
instruado|instru-ad-o
ple|
«ji|
lieĝo|li-eĝ-o
normala|normal-a
vestita|vest-it-a
kompreni|kompren-i
oni|oni
helpo|help-o
vatikana|
korko|kork-o
fotokopii|fotokopi-i
eligi|el-ig-i
eva|
ĝusta|ĝust-a
tendo|tend-o
ene|en-e
doktoro|doktor-o
raporto|raport-o
suker-peco|suker-pec-o
kunveturi|kun-vetur-i
dolĉa|dolĉ-a
dolĉaĵo|dolĉ-aĵ-o
okulo|okul-o
tablo|tabl-o
simila|simil-a
monta|mont-a
antaŭ|antaŭ
konsistigi|konsist-ig-i
perdita|perd-it-a
iri|ir-i
manĝi|manĝ-i
aspekto|aspekt-o
lito|lit-o
brun-hara|brun-har-a
brakseĝo|brak-seĝ-o
kuraĝe|kuraĝ-e
ĝenerale|ĝeneral-e
eldono|el-don-o
meti|met-i
aŭta|aŭt-a
pseŭdonimo|pseŭdonim-o
apliki|aplik-i
instigi|instig-i
romaneto|roma-net-o
tiamaniere|tia-manier-e
bonkora|bon-kor-a
bezoni|bezon-i
aranĝo|aranĝ-o
kontraŭ|kontraŭ
ekiri|ek-ir-i
gejunulo|ge-jun-ul-o
patrineto|patri-net-o
malproksime|mal-proksim-e
22|
san-stato|san-stat-o
surkaseda|sur-kased-a
montri|montr-i
akcepti|akcept-i
dolore”|
persekutado|persekut-ad-o
pozicio|pozici-o
konstati|konstat-i
desegno|desegn-o
kurso|kurs-o
paperujo|paper-uj-o
unua|unu-a
kunveno|kun-ven-o
ĉi-lasta|ĉi-last-a
surprizi|surpriz-i
ŝajne|ŝajn-e
domo|dom-o
krom|krom
apud|apud
kapjesi|kap-jes-i
monda|mond-a
io|io
rebonigi|re-bon-ig-i
devigi|dev-ig-i
saĝe|saĝ-e
signo|sign-o
serio|seri-o
eble|ebl-e
flug-haveno|flug-haven-o
pludungi|plu-dung-i
banala|banal-a
alveni|al-ven-i
bando|band-o
plene|plen-e
informi|inform-i
milito|milit-o
kelktempe|kelk-temp-e
kruro|krur-o
haro|har-o
ilia|ili-a
fidinda|fid-ind-a
kirurgia|kirurgi-a
supernacia|super-naci-a
e|e
travivi|tra-viv-i
punkto|punkt-o
vojaĝi|vojaĝ-i
raporti|raport-i
o|o
malsana|mal-san-a
neebla|ne-ebl-a
listigi|list-ig-i
necese|neces-e
via|vi-a
vendi|vend-i
religio|religi-o
prizorgante|pri-zorg-ant-e
finfine|fin-fin-e
literaturo|literatur-o
apude|apud-e
dio|di-o
atmosfero|atmosfer-o
hodiaŭ|hodiaŭ
verŝajne|ver-ŝajn-e
ĉesi|ĉes-i
nova|nov-a
aero|aer-o
voki|vok-i
proporcio|proporci-o
malpli|
etulino|et-ul-in-o
malplena|mal-plen-a
studi|stud-i
praktike|praktik-e
ripari|ripar-i
pro|
farti|fart-i
kafpulvoro|kaf-pulvor-o
interesiĝi|interes-iĝ-i
san-franciska|
deksepa|dek-sep-a
blua|blu-a
dormanta|dorm-ant-a
certe|cert-e
reguleco|regul-ec-o
mallibera|mal-liber-a
turni|turn-i
malfermita|mal-ferm-it-a
trejniĝi|trejn-iĝ-i
sin-donema|sin-don-em-a
forto|fort-o
aĵo|aĵ-o
ŝipo|ŝip-o
multe|mult-e
transiri|trans-ir-i
senvorta|sen-vort-a
kriptaĵo-scienco|kript-aĵo-scienc-o
sekundo|sekund-o
okupiĝi|okup-iĝ-i
ĝentila|ĝentil-a
rekunmeti|re-kun-met-i
enhavi|en-hav-i
vido|vid-o
paŝo|paŝ-o
seke|sek-e
ripeto|ripet-o
aviadile|aviad-il-e
suferi|sufer-i
16|
23|
manki|mank-i
forpreni|for-pren-i
3|
okupi|okup-i
daŭri|daŭr-i
detala|detal-a
alta|alt-a
injekti|injekt-i
ĵeti|ĵet-i
preferi|prefer-i
dume|dum-e
monto|mont-o
kutime|kutim-e
trovi|trov-i
lernolibro|
sincera|sincer-a
glasa|glas-a
rapidiĝi|rapid-iĝ-i
atento-kapta|atento-kapt-a
aresti|arest-i
sub|sub
povi|pov-i
furioze|furioz-e
miri|mir-i
malfermeti|mal-fer-met-i
chapecó|
drama|dram-a
brakhorloĝo|brak-horloĝ-o
aventuro|aventur-o
espereble|esper-ebl-e
malŝati|mal-ŝat-i
privata|privat-a
danci|danc-i
vorto|vort-o
v|
statistika|statistik-a
dokumento|dokument-o
fuŝa|fuŝ-a
romano|roman-o
tria|tri-a
i|i
ridaĉo|rid-aĉ-o
trinki|trink-i
vetero|veter-o
pridemandi|pri-demand-i
forturni|for-turn-i
iom|iom
malsaĝe|mal-saĝ-e
kabineto|kabinet-o
konsentinta|konsent-int-a
estiĝi|est-iĝ-i
maltrankviliĝi|mal-trankvil-iĝ-i
decido|decid-o
12|
2|
plendi|plend-i
soifa|soif-a
4|
malfrue|mal-fru-e
revidi|re-vid-i
pan-|
s|
amegi|am-eg-i
vere|ver-e
tikli|tikl-i
ĝenevo|
kap-jesi|kap-jes-i
koro|kor-o
verdire|ver-dir-e
fal-sidi|fal-sid-i
fariĝi|far-iĝ-i
ŝlosi|ŝlos-i
spione|spion-e
decidi|decid-i
duone|du-on-e
nekredeble|ne-kred-ebl-e
aperi|aper-i
mesaĝo|mesaĝ-o
feliĉigi|feliĉ-ig-i
89|
persono|person-o
silentado|silent-ad-o
kune|kun-e
pure|pur-e
fuŝi|fuŝ-i
scivola|sci-vol-a
regulo|regul-o
stulteco|stult-ec-o
multa|mult-a
ĉifoje|ĉi-foj-e
veturi|vetur-i
perforte|per-fort-e
esperantisto|esper-ant-ist-o
forte|fort-e
ekstrem-oriento|ekstrem-orient-o
belega|be-leg-a
radiko|radik-o
vorto-provizo|vorto-proviz-o
bona|bon-a
ricevita|ricev-it-a
telera|teler-a
malĝojeta|mal-ĝoj-et-a
vizitanto|vizit-ant-o
por|por
21|
libro|libr-o
domaĉo|do-maĉ-o
botelo|botel-o
bela|bel-a
skribi|skrib-i
blondulo|blond-ul-o
tra|tra
inter-soldata|inter-soldat-a
judo|jud-o
laboro|labor-o
protekti|protekt-i
mistere|mister-e
ie|ie
kriegi|kri-eg-i
92|
1|
poŝo|poŝ-o
13|
tii|
psikologia|psikologi-a
ekirigi|ek-ir-ig-i
sinteno|sin-ten-o
l'|
maldikuleto|mal-dik-ul-et-o
absorbita|absorb-it-a
pano|pan-o
spirita|spirit-a
ekdormi|ek-dorm-i
popolo|popol-o
observata|observ-at-a
indiki|indik-i
numero|numer-o
sola|sol-a
aŭdiĝi|aŭd-iĝ-i
agema|ag-em-a
lando|land-o
”|
kelkfoje|kelk-foj-e
observi|observ-i
kunlaboranto|kun-labor-ant-o
akompani|akompan-i
materialo|material-o
vekiĝi|vek-iĝ-i
sciante|sci-ant-e
tia|tia
feria|feri-a
valora|valor-a
krima|krim-a
teatro|teatr-o
indiko|indik-o
informiĝi|inform-iĝ-i
nomata|nom-at-a
samnivela|sam-nivel-a
15|
planita|plan-it-a
kredinda|kred-ind-a
ĝia|ĝi-a
lasante|las-ant-e
unufoje|unu-foj-e
gerda|
problemo|problem-o
dank'|dank-o
blonda|blond-a
lernendaĵo|lern-end-aĵ-o
tute|tut-e
devi|dev-i
sin-sekve|sin-sekv-e
honeste|honest-e
ji|
ne-kredeble|ne-kred-ebl-e
gardo-stari|gardo-star-i
aŭto|aŭt-o
profesorino|profesor-in-o
saluto|salut-o
sun-lumo|sun-lum-o
ĵi|
piediri|pied-ir-i
porti|port-i
niaepoke|nia-epok-e
ha|ha
senmanke|sen-mank-e
montriĝi|montr-iĝ-i
ŝato|ŝat-o
spiona|spion-a
1981|
halti|halt-i
plenda|plend-a
eĉ|eĉ
informita|inform-it-a
ĉiujare|ĉiu-jar-e
bonŝanca|bon-ŝanc-a
malbela|mal-bel-a
mem-serva|mem-serv-a
legolibro|lego-libr-o
prilaborado|pri-labor-ad-o
aŭtoritato|aŭtoritat-o
ortodoksulo|ortodoks-ul-o
risko|risk-o
kies|kies
furioza|furioz-a
prepari|prepar-i
milit-servi|milit-serv-i
proksimiĝi|proksim-iĝ-i
ĉi-foje|ĉi-foj-e
rajti|rajt-i
malrapide|mal-rapid-e
spionino|spion-in-o
fakto|fakt-o
espere|esper-e
angulo|angul-o
lui|lu-i
ŝiri|ŝir-i
fonti|font-i
malbono|mal-bon-o
forgesiĝi|forges-iĝ-i
kiel|kiel
serpento|serpent-o
flanko|flank-o
aŭtomate|aŭtomat-e
komprenebla|kompren-ebl-a
salti|salt-i
adiaŭ|adiaŭ
konversacio|konversaci-o
pseŭdo-turka|
bob|
multvalora|mult-valor-a
respondi|respond-i
esperanto|esper-ant-o
elirante|el-ir-ant-e
senpezigi|sen-pez-ig-i
muziko|muzik-o
plia|pli-a
kasedo|kased-o
vortaro|vort-ar-o
fantazie|fantazi-e
18|
–|
17|
fantomino|fantom-in-o
ĝeneva|
fuŝita|fuŝ-it-a
gepatro|ge-patr-o
ofte|oft-e
dormiga|dorm-ig-a
respekti|respekt-i
20|
8|
danĝera|danĝer-a
proksimume|proksim-um-e
61|
kvankam|kvankam
ektimi|ek-tim-i
rimarkinda|rimark-ind-a
ĉii|ĉi-i
plano|plan-o
forsveni|for-sven-i
senkonsciigita|sen-konsci-ig-it-a
tago|tag-o
aliflanke|ali-flank-e
devojiĝi|de-voj-iĝ-i
ĉambraĉo|ĉambr-a\u0109-o
ekrigardi|ek-rigard-i
antaŭsenti|antaŭ-sent-i
kuracisto|kurac-ist-o
luita|lu-it-a
aŭ|aŭ
serĉe|serĉ-e
m|
ripetiĝi|ripet-iĝ-i
forporti|for-port-i
malproksima|mal-proksim-a
44|
koridoro|koridor-o
diable|diabl-e
kono|kon-o
kvi|
pligrandigi|pli-grand-ig-i
subite|subit-e
trinkaĵo|trink-aĵ-o
meblo|mebl-o
asimiliĝi|asimil-iĝ-i
lernanto|lern-ant-o
malsekeco|mal-sek-ec-o
mortigi|mort-ig-i
portata|port-at-a
«virino»|
rakonti|rakont-i
retrankviliĝi|re-trankvil-iĝ-i
elportebla|el-port-ebl-a
grave|grav-e
skribita|skrib-it-a
19|
maldika|mal-dik-a
malŝato|mal-ŝat-o
hospitalo|hospital-o
ĉiaspeca|ĉia-spec-a
kontentige|kontent-ig-e
ok|ok
atente|atent-e
supre|supr-e
aliri|al-ir-i
dekoka|de-kok-a
psikanalizisto|psik-analiz-ist-o
pan-|
malpli|
perfekta|perfekt-a
el|el
flegistino|fleg-ist-in-o
tuta|tut-a
ripetadi|ripet-ad-i
bob|
opinii|opini-i
kio|kio
kuko|kuk-o
helpe|help-e
destino|destin-o
kie|kie
forlasita|for-las-it-a
ankoraŭ|ankoraŭ
oranĝo|oranĝ-o
prizorgi|pri-zorg-i
krome|krom-e
maltrankvila|mal-trankvil-a
proponi|propon-i
kontraŭo|kontraŭ-o
aparato|aparat-o
nekonscia|ne-konsci-a
papero|paper-o
sukerujo|suker-uj-o
malaperi|mal-aper-i
alkape|al-kap-e
junulo|jun-ul-o
alia|ali-a
organizo|organiz-o
9|
amatore|amator-e
vatikana|
nove|nov-e
tomato|tomat-o
am-deklaro|am-deklar-o
papera|paper-a
meze|mez-e
prave|prav-e
da|
forkuri|for-kur-i
vi|vi
solvi|solv-i
per|per
enmeti|en-met-i
ekhalti|ek-halt-i
dormĉambro|dorm-ĉambr-o
veturilo|vetur-il-o
|
amikiĝi|amik-iĝ-i
emo|em-o
ekstari|ek-star-i
zorgeme|zorg-em-e
glaso|glas-o
vendejo|vend-ej-o
pardoni|pardon-i
ĝeneva|
malsama|mal-sam-a
esperi|esper-i
longega|long-eg-a
sukcesi|sukces-i
rakonto|rakont-o
ripeti|ripet-i
naskiĝi|nask-iĝ-i
marta|mart-a
malforte|mal-fort-e
malsato|mal-sat-o
profesoro|profesor-o
atentema|atent-em-a
nenio|nenio
psiko-pedagogio|psiko-pedagogi-o
malkomforta|mal-komfort-a
alvenanto|al-ven-ant-o
jarcento|jar-cent-o
rapidi|rapid-i
ronda|rond-a
fakte|fakt-e
tera|ter-a
universitato|universitat-o
vero|ver-o
timi|tim-i
pulvora|pulvor-a
fergi|
ple|
same|sam-e
noktiĝi|nokt-iĝ-i
veturado|vetur-ad-o
traduka|traduk-a
simpla|simpl-a
fidi|fid-i
ĝeme|ĝem-e
ekzisto|ekzist-o
ji|
kunigi|kun-ig-i
eva|
ĉiaokaze|ĉia-okaz-e
permeso|permes-o
kelka|kelk-a
silentigi|silent-ig-i
treege|tre-eg-e
nazon-al-nazo|naz-on-al-naz-o
afereto|afer-et-o
mateno|maten-o
malpermesita|mal-permes-it-a
malvere|mal-ver-e
severe|sever-e
v|
elito|elit-o
temperaturo|temperatur-o
konsentite|konsent-it-e
ĉokolado|ĉokolad-o
vestaĵo|vest-aĵ-o
brazilo|
grav-aspekta|grav-aspekt-a
precipe|precip-e
numer-plato|numer-plat-o
ili|ili
fraŭlino|fraŭl-in-o
ol|ol
radio-kaj-kased-aparato|radio-kaj-kased-aparat-o
imago|imag-o
oficejo|ofic-ej-o
funkcii|funkci-i
inter|inter
komenciĝi|komenc-iĝ-i
sekigi|sek-ig-i
dekstra|dekstr-a
plenigita|plen-ig-it-a
hundo|hund-o
difinita|difin-it-a
malsati|mal-sat-i
«urĝa»|
lingvo|lingv-o
helpa|help-a
historio|histori-o
a|a
kriaĉi|kri-aĉ-i
temo|tem-o
seĝo|seĝ-o
trinkebla|trink-ebl-a
varmeta|var-met-a
kisi|kis-i
mano|man-o
senkonscia|sen-konsci-a
replenigi|re-plen-ig-i
bileto|bilet-o
urĝi|urĝ-i
panejo|pan-ej-o
nemovebla|ne-mov-ebl-a
redoni|re-don-i
bruego|bru-eg-o
kia|kia
fermiĝi|ferm-iĝ-i
elza|
superi|super-i
budhano|budh-an-o
riĉa|riĉ-a
penso|pens-o
alparoli|al-parol-i
sama|sam-a
elpensinta|el-pens-int-a
svisa|svis-a
savi|sav-i
peza|pez-a
foje|foj-e
pied-batante|pied-bat-ant-e
konsidero|konsider-o
ĉio|ĉio
rekoni|re-kon-i
sur|sur
viro|vir-o
utiligante|util-ig-ant-e
2|
infana|infan-a
trankvila|trankvil-a
kii|
13|
redukti|redukt-i
ĝuste|ĝust-e
aliĝi|al-iĝ-i
provante|prov-ant-e
institucio|instituci-o
necesi|neces-i
trifoje|tri-foj-e
onklino|onkl-in-o
ĉi-matene|ĉi-maten-e
plezura|plezur-a
plena|plen-a
kadro|kadr-o
malkaŝi|mal-kaŝ-i
gravulo|grav-ul-o
novjorko|
motivo|motiv-o
longe|long-e
nia|ni-a
mem|mem
11|
samklasano|sam-klas-an-o
veki|vek-i
morala|moral-a
92|
ekzisti|ekzist-i
diro|dir-o
malfacila|mal-facil-a
82|
ŝajni|ŝajn-i
laŭ|laŭ
digneco|dign-ec-o
iam|iam
petro|
evidente|evident-e
4|
ekstera|ekster-a
vidi|vid-i
post|post
trovaĵo|trov-aĵ-o
gerda|
24|
imagi|imag-i
ĝustatempe|ĝusta-temp-e
plafono|plafon-o
paĝo|paĝ-o
bonvolo|bon-vol-o
paŝi|paŝ-i
larĝe|larĝ-e
johá|
leginto|leg-int-o
rekaŝi|re-kaŝ-i
tom|
fari|far-i
ŝajnigi|ŝajn-ig-i
prefere|prefer-e
3|
tre|tre
ii|
kora|kor-a
plua|plu-a
instruo|instru-o
aventur-romano|aventur-roman-o
kelksemajna|kelk-semajn-a
alpreni|al-pren-i
kara|kar-a
metodo|metod-o
travivebla|tra-viv-ebl-a
nenatura|ne-natur-a
enveno|en-ven-o
kaverno|kavern-o
claude|
”|
kriptaĵoscienco|kript-aĵo-scienc-o
mi|mi
nokto|nokt-o
do|
knabo|knab-o
elpreni|el-pren-i
ĉiam|ĉiam
ŝlosita|ŝlos-it-a
internacia|inter-naci-a
senorda|se-nord-a
malhelpo|mal-help-o
7|
aŭdante|aŭd-ant-e
enhavo|en-hav-o
prof|
kaŝa|kaŝ-a
18|
17|
silentema|silent-em-a
vortlisto|vort-list-o
unuflanke|unu-flank-e
kovri|kovr-i
8|
tro|
plani|plan-i
informo|inform-o
serioze|serioz-e
manĝinda|manĝ-ind-a
ŝanĝiĝi|ŝanĝ-i\u011d-i
mensa|mens-a
progresanto|progres-ant-o
malbone|mal-bon-e
12|
minuto|minut-o
44|
psikoterapeŭto|
uzita|uz-it-a
provo|prov-o
linda|
demandi|demand-i
21|
islamano|islam-an-o
frato|frat-o
membro|membr-o
komprene|kompren-e
malsekiĝi|mal-sek-iĝ-i
ĉiufoje|ĉiu-foj-e
finiĝi|fin-iĝ-i
kelnero|kelner-o
parto|part-o
preciza|preciz-a
epoko|epok-o
kafo|kaf-o
perfekteco|perfekt-ec-o
persekuti|persekut-i
aŭte|aŭt-e
gramatika|gramatik-a
tasko|task-o
unue|unu-e
ankaŭ|ankaŭ
senigi|sen-ig-i
silente|silent-e
cent|cent
metita|met-it-a
serĉanta|serĉ-ant-a
nur|nur
gefrato|ge-frat-o
ruĝiĝi|ruĝ-i\u011d-i
klasĉambro|klas-ĉambr-o
fino|fin-o
6|
danko|dank-o
substanco|substanc-o
krie|kri-e
lumi|lum-i
aŭskulti|aŭskult-i
se|se
scivolo|sci-vol-o
uzi|uz-i
lernado|lern-ad-o
kompatinda|kompat-ind-a
ludi|lud-i
arto|art-o
kapablo|kapabl-o
materia|materi-a
baldaŭ|baldaŭ
respekto|respekt-o
vojaĝo|vojaĝ-o
poemaro|poem-ar-o
tiel|tiel
poste|post-e
procento|procent-o
zagreg|
provi|prov-i
temi|tem-i
aŭto-pordo|aŭto-pord-o
venigi|ven-ig-i
traduko|traduk-o
policano|polic-an-o
sinjorino|sinjor-in-o
flanke|flank-e
senstreĉa|sen-streĉ-a
parolema|parol-em-a
plori|plor-i
-|
kaptilo|kapt-il-o
aŭdi|aŭd-i
frukto|frukt-o
scivoli|sci-vol-i
timema|tim-em-a
dika|dik-a
pacifika|pa-ci-fik-a
«narko-analizo»|
nacia|naci-a
movinta|mov-int-a
di|
pri|
rigardi|rigard-i
klarigo|klar-ig-o
sekreta|sekret-a
pagi|pag-i
klare|klar-e
survizaĝe|sur-vizaĝ-e
tii|
aŭtoro|aŭtor-o
banĉambro|ban-ĉambr-o
tial|tial
mono|mon-o
fratino|frat-in-o
de|de
manĝo|manĝ-o
pensadi|pens-ad-i
tiutempe|tiu-temp-e
natura|natur-a
specialisto|special-ist-o
favori|favor-i
dankemo|dank-em-o
elpensi|el-pens-i
interparoli|inter-parol-i
promesi|promes-i
esti|est-i
prezenti|prezent-i
ekvidi|ek-vid-i
gramatiko|gramatik-o
kursmaterialo|kurs-material-o
varma|varm-a
pripensema|pri-pens-em-a
revido|re-vid-o
spiono|spion-o
reagi|re-ag-i
ja|ja
multkolora|mult-kolor-a
pomo|pom-o
grupo|grup-o
terure|terur-e
sekvi|sekv-i
strange|strang-e
neeble|ne-ebl-e
kokidaĵo|kok-id-aĵ-o
kompati|kompat-i
f-ino|fin-o
fakulo|fak-ul-o
esprimante|esprim-ant-e
mekanikisto|mekanik-ist-o
kontraŭdiro|kontraŭ-dir-o
patro|patr-o
forta|fort-a
enkonduki|en-konduk-i
vortigi|vort-ig-i
grava|grav-a
soifo|soif-o
precize|preciz-e
aranĝi|aranĝ-i
gramatikaĵo|gramatik-aĵ-o
bedaŭri|bedaŭr-i
havigi|hav-ig-i
14|
disponi|dispon-i
alproksimiĝi|al-proksim-iĝ-i
35|
frateco|frat-ec-o
renkontiĝi|renkont-iĝ-i
krip-ta-ĵo-sci-en-co|kript-aĵo-scienc-o
«virino»|
plenplena|plen-plen-a
operacio|operaci-o
deklaro|deklar-o
16|
teksto|tekst-o
batita|bat-it-a
korpo|korp-o
«kriptografio»|
principo|princip-o
facile|facil-e
flugi|flug-i
sveno|sven-o
mispensi|mis-pens-i
novulo|nov-ul-o
faktultato|
indikita|indik-it-a
laciga|lac-ig-a
vesto|vest-o
signalo|signal-o
malpermesite|mal-permes-it-e
bedaŭrinda|bedaŭr-ind-a
ebligi|ebl-ig-i
aĉulo|aĉ-ul-o
lumo-serĉanto|lumo-serĉ-ant-o
vizaĝa|vizaĝ-a
retrovi|re-trov-i
invito|invit-o
1981|
sako|sak-o
amatoro|amator-o
detektiv-romano|detektiv-roman-o
zorge|zorg-e
infaneco|infan-ec-o
pura|pur-a
diri|dir-i
danka|dank-a
grandega|grand-eg-a
voli|vol-i
memoro|memor-o
valoro|valor-o
ebli|ebl-i
mirigi|mir-ig-i
paroligi|parol-ig-i
elemento|element-o
kolego|koleg-o
ho|
aparta|apart-a
facila|facil-a
malo|mal-o
multekosta|multe-kost-a
respondo|respond-o
ideo|ide-o
kvi|
plaĉi|plaĉ-i
«jes»|
lacega|lac-eg-a
lingvistiko|lingvistik-o
videble|vid-ebl-e
dolori|dolor-i
vizaĝo|vizaĝ-o
savita|sav-it-a
riskema|risk-em-a
regiono|region-o
stariĝi|star-iĝ-i
tiom|tiom
demandante|demand-ant-e
antaŭlonge|antaŭ-long-e
rompi|romp-i
knabino|knab-in-o
simple|simpl-e
viziti|vizit-i
sc|
nenie|nenie
helpema|help-em-a
duba|dub-a
klarigi|klar-ig-i
veni|ven-i
dolĉaĵ-vendejo|dolĉ-aĵ-vend-ej-o
ambaŭ|ambaŭ
t|
lerni|lern-i
89|
kuraĝa|kuraĝ-a
dufoje|du-foj-e
dolore”|
insisti|insist-i
disvolviĝi|dis-volv-iĝ-i
afabla|afabl-a
alporti|al-port-i
familio|famili-o
«ne»|
ĝin»|
pripensi|pri-pens-i
soni|son-i
jesi|jes-i
trankvile|trankvil-e
l'|
denove|de-nov-e
kontentigi|kontent-ig-i
konstante|konstant-e
reciproke|reciprok-e
kanti|kant-i
ĝi|ĝi
memlernado|mem-lern-ad-o
tio|tio
fantomo|fantom-o
somera|somer-a
kaŝejo|kaŝ-ej-o
ka|
rekuŝiĝi|re-kuŝ-iĝ-i
1|
kontenta|kontent-a
certeco|cert-ec-o
atentinda|atent-ind-a
starigi|star-ig-i
certa|cert-a
bazo|baz-o
ti|
propono|propon-o
tipo|tip-o
sekvado|sek-vad-o
urbego|urb-eg-o
aventurema|aventur-em-a
observemo|observ-em-o
varme|varm-e
uni|
piede|pied-e
influo|influ-o
almenaŭ|almenaŭ
verko|verk-o
rilato|rilat-o
videbli|vid-ebl-i
mezo|mez-o
evidentiĝi|evident-iĝ-i
patrino|patr-in-o
edukscienca|eduk-scienc-a
ki|
ridi|rid-i
bonkore|bon-kor-e
koncerna|koncern-a
ŝtato|ŝtat-o
ne|ne
enamiĝi|en-am-iĝ-i
fojo|foj-o
relegi|re-leg-i
urĝas”|
riski|risk-i
stulta|stult-a
digne|dign-e
evidenta|evident-a
grupe|grup-e
hieraŭ|hieraŭ
suno|sun-o
interesi|interes-i
kuraĝo|kuraĝ-o
ĵi|
bakita|bak-it-a
ŝipe|ŝip-e
malliberigi|mal-liber-ig-i
«ji|
chapecó|
supo|sup-o
klara|klar-a
tempo|temp-o
decidita|decid-it-a
nefidinda|ne-fid-ind-a
nekonscie|ne-konsci-e
esperante|esper-ant-e
malfacile|mal-facil-e
morti|mort-i
turka|turk-a
promeso|promes-o
ia|ia
turka-kafa|turka-kaf-a
perfekte|perfekt-e
kalifornia|kaliforni-a
infano|infan-o
komenco|komenc-o
tame|
paro|par-o
horloĝo|horloĝ-o
ralf|
eksiĝo|eks-iĝ-o
pseŭdo-turka|
5|
kvazaŭ|kvazaŭ
naŭ|naŭ
kapo|kap-o
ree|re-e
maldekstra|mal-dekstr-a
brui|bru-i
sporada|sporad-a
s|
daŭra|daŭr-a
interveni|inter-ven-i
plaĉe|plaĉ-e
sidloko|sid-lok-o
samicler|
praktiki|praktik-i
vortero|vor-ter-o
suspekte|suspekt-e
motoro|motor-o
salato|salat-o
pravi|prav-i
fini|fin-i
ĝoje|ĝoj-e
ekde|
heziti|hezit-i
ami|am-i
laŭofteca|laŭ-oft-ec-a
eksekvi|ek-sekv-i
ama|am-a
amdeklaro|am-deklar-o
kompreno|kompren-o
nehome|ne-hom-e
dikiĝi|dik-iĝ-i
neniam|neniam
biero|bier-o
belgio|
vivo|viv-o
adaptiĝi|adapt-iĝ-i
akompana|akompan-a
23|
justeco|just-ec-o
danĝere|danĝer-e
m|
paralela|paralel-a
=|
pasi|pas-i
krii|kri-i
19|
historiisto|histori-ist-o
sekreto|sekret-o
kuri|kur-i
tri|
malsaĝeco|mal-saĝ-ec-o
plorigi|plor-ig-i
espero|esper-o
komence|komenc-e
eksplodi|eksplod-i
sveni|sven-i
atento|atent-o
ronga|
tuŝi|tuŝ-i
urbocentro|urbo-centr-o
ebla|ebl-a
agi|ag-i
estimata|estim-at-a
okazaĵo|okaz-aĵ-o
ĉefa|ĉef-a
homo|hom-o
instrua|instru-a
katoliko|katolik-o
vera|ver-a
plezure|plezur-e
magazeno|magazen-o
aviadilo|aviad-il-o
malpurigi|mal-pur-ig-i
grasa|gras-a
san-franciska|
speciale|special-e
fotokopio|fotokopi-o
lernolibro|
paroladi|paro-lad-i
muzikisto|muzik-ist-o
super|super
kolekto|kolekt-o
senforta|sen-fort-a
detektiva|detektiv-a
laŭte|laŭt-e
dankegi|dank-eg-i
hazarde|hazard-e
voĉo|voĉ-o
ŝtelita|ŝtel-it-a
libereco|liber-ec-o
suko|suk-o
sufiĉi|sufiĉ-i
aspekti|aspekt-i
foriri|for-ir-i
al|al
absurda|absurd-a
jena|jen-a
humura|humur-a
eta|et-a
brando|brand-o
reŝlosi|re-ŝlos-i
motivado|motiv-ad-o
proksime|proksim-e
grandulo|grand-ul-o
paliĝi|pal-iĝ-i
amo|am-o
valano|val-an-o
kaŝi|kaŝ-i
tradukisto/protokolisto|
insularo|insul-ar-o
troviĝinta|trov-iĝ-int-a
ruĝa|ruĝ-a
kunteksto|kun-tekst-o
enmiksiĝi|en-miks-iĝ-i
reago|re-ag-o
memori|memor-i
diskuti|diskut-i
unuvorte|unu-vort-e
gvidi|gvid-i
liber-tempi|liber-temp-i
speciala|special-a
rolo|rol-o
kovrila|kovr-il-a
bati|bat-i
malŝatinda|mal-ŝat-ind-a
sed|sed
celo|cel-o
jaro|jar-o
peca|pec-a
interrompi|inter-romp-i
kunlabori|kun-labor-i
laborema|labor-em-a
studentino|student-in-o
senti|sent-i
kaptinto|kapt-int-o
objekto|objekt-o
instru-unuo|instru-unu-o
saluti|salut-i
veturigi|vetur-ig-i
disponigi|dispon-ig-i
bato|bat-o
pensante|pens-ant-e
filozofia|filozofi-a
altlernejo|alt-lern-ej-o
komforte|komfort-e
labori|labor-i
dormo|dorm-o
konsenti|konsent-i
historia|histori-a
plurfoja|plur-foj-a
menuo|menu-o
manko|mank-o
letero|leter-o
ĝenevo|
multo|mult-o
momento|moment-o
kial|kial
permesi|permes-i
silenti|silent-i
konscio|konsci-o
varmaĉa|var-maĉ-a
chaux-de-fonds|
rememori|re-memor-i
strato|strat-o
sukcese|sukces-e
suferigi|sufer-ig-i
mallaŭte|mal-laŭt-e
kunmeti|kun-met-i
sano|san-o
danĝero|danĝer-o
strukturo|struktur-o
juna|jun-a
ema|em-a
uzante|uz-ant-e
troa|tro-a
atendanto|atend-ant-o
kontentiga|kontent-ig-a
atenti|atent-i
filino|fil-in-o
malfermi|mal-ferm-i
uzinte|uz-int-e
petegi|pet-eg-i
suferiga|sufer-ig-a
diskreta|diskret-a
plorema|plor-em-a
maro|mar-o
malfeliĉa|mal-feliĉ-a
observejo|observ-ej-o
saĝa|saĝ-a
afriko|
kosadi|
elita|elit-a
ĝeni|ĝen-i
rimarki|rimark-i
bruo|bru-o
haltejo|halt-ej-o
enŝlosi|en-ŝlos-i
peti|pet-i
laca|lac-a
kiam|kiam
maldiskreti|mal-diskret-i
aranĝita|aranĝ-it-a
enŝlosita|en-ŝlos-it-a
esplori|esplor-i
eniri|en-ir-i
malĝoja|mal-ĝoj-a
bonvena|bon-ven-a
ulo|ul-o
nome|nom-e
ŝanco|ŝanc-o
dubi|dub-i
marko|mark-o
pro|
atendado|atend-ad-o
tradukistoprotokolisto|traduk-ist-op-roto-kol-ist-o
tiu|tiu
pri|???
ji|???
patron|patr-on
ple|???
psikoterapeŭto|???
urĝas”|???
min|min
samicler|???
ni|???
tii|???
lin|lin
amas|am-as
ki|???
t|???
lernolibro|???
linda|???
johá|???
elza|???
ĵi|???
vatikana|???
dolore”|???
kvi|???
l'|???
zagreg|???
–|???
urĝa|urĝ-a
ĉu|ĉu
ĝin|ĝin
pseŭdo-turka|???
da|???
ho|???
=|???
sin|sin
pan-|???
fergi|???
v|???
sc|???
m|???
belgio|???
faktultato|???
ralf|???
tom|???
tri|???
malpli|???
petro|???
do|???
iris|ir-is
tuj|tuj
kapon|kap-on
”|???
claude|???
s|???
san-franciska|???
chaux-de-fonds|???
narko-analizo|???
kosadi|???
tro|???
ronga|???
ej|ej
|???
gerda|???
bob|???
-|???
kii|???
di|???
novjorko|???
eva|???
unu|unu
kriptografio|krip-tog-rafi-o
n|???
ĝeneva|???
brazilo|???
ĝenevo|???
pro|???
chapecó|???
kaj|kaj
afriko|???
tamen|???
prof|???
ekde|???
lian|li-an
ii|???
vin|vin
trinko|trink-o
